┌────────────────────────────────────────────────────────────────────────────────────────────┐
│********************************************************************************************│
│********************************************************************************************│
│********************************************************************************************│
│******************************************* ** *********************************************│
│****************************** **********  *********  ********** * ** ** ***    ************│
│******************************       ******                        ********** **************│
│*****************************                                    *****  **   ***************│
│****************************                                     *  ************************│
│          **  *** *********                                       **************************│
│         *** * *  **    **                                                                  │
│         ****  *  **   **                                                                   │
│          **   * ***  **                                                                    │
│              *** * **                                                                      │
│              **  **                                                                        │
│                                                                                            │
│                                                                                            │
│                                                                                            │
│"""""""""""""""""""""""""""""""""""                                                         │
│                                                                                            │
│                                                                                            │
│                                                                                            │
│                                                                                            │
│############################################################################################│
│############################################################################################│
│############################################################################################│
└────────────────────────────────────────────────────────────────────────────────────────────┘